   EA    ./assets/collectible.xpm

SO        ./assets/collectible.xpm


NO ./assets/collectible.xpm


   WE ./assets/collectible.xpm

C 0,25,30
F 0,25,30


                         111111111
                        1000000N001
                         111111111