   EA    assets/textures/walls/stone_bricks/1.xpm

SO        assets/textures/walls/stone_bricks/2.xpm
NO
NO assets/textures/walls/stone_bricks/3.xpm


   WE assets/textures/walls/stone_bricks/4.xpm


C assets/sky/mountains/mountains.xpm
F assets/textures/floor/sand.xpm

                         111111111
                        10000000001
                        10000000001
                         100000001
11111    111111111111111111000001
10001    100000000000000000000001
10S011111101111111111111111000001
10001    100000000000000001111111
11011    111111111111111101                           111111
100011111110000000000000001                          10000001
10001000011011111111111111111111111111111           1000000001
1000000001101               1000000000001          100000000001
1003100001101               100000000000111111111110000000000001
100011111110111111          100000000000000000000000000002000001
100011000200200001          100000300000111111111110000000000001
100011000000000001          1000000000001          100000000001
10021100000000000111111111111000000000001           1000000001
10001100000000000000000000000000011111111            10000001
1000110000000000011111111111110001                    111111
140001300000000001           10001
100000000000000001           10001
100001300000000001           10001
100011000000000001           10001
140011000000000001          10001
100011000000000001         10001
100011000000000001        10001
100011111111111111       10001
10001            11111  10001
1001          11100000110001
101         110000000000001
101        10000000000000001
101       1000000000000000001
101111111100000000000000000001
100000000000000000000000000001
111111111100000000000000000001
          1000000000000000001
           10000000000000001
            110000000000011
              11100000111
                 11111