   EA    ./assets/carpet1.xpm

SO        ./assets/carpet2.xpm


NO ./assets/carpet3.xpm


   WE ./assets/carpet4.xpm

C 0,25,30
F 0,25,30

 111111111
10000000001
1000000W011
10001000001
 111111111