   EA    ./assets/collectible.xpm

SO        ./assets/collectible.xpm


NO ./assets/collectible.xpm


   WE ./assets/collectible.xpm

C ./assets/collectible.xpm
F ./assets/collectible.xpm


                         111111111
                        10000000001
                         111111111