   EA    ./assets/collectible.xpm

SO        ./assets/collectible.xpm


NO ./assets/collectible.xpm


   WE ./assets/collectible.xpm

C 0,25,30
F 0,25,30


                         111111111
                        10000001001
                        1000000N001
                        10000000001
                         111111111
