NO ./assets/carpet1.xpm
EA ./assets/carpet2.xpm
SO ./assets/carpet3.xpm
WE ./assets/carpet4.xpm

C 128,255,255
F 20,10,255


1111111111111111111111111111111111111111111111111111111111111111111111111111111111111111111111111111111111
1000001000001100001000001000000000100000000011111111110000100000110000100000100000000010000000000000000001
10E00010000001000010000010000100000100000000111111111100000100000010000100000100001000001000000000000000001
100000100001000000100000100001000000100000000000000000000010000100000010000010000100000010000000000000000111111111111111111111
100000100001000000100010000001000000010000001111111111000010000100000010001000000100000001000000000000000000000000000000000001
100000000001000000101000100001000000000000001111111111000000000100000010100010000100000000000000000000000111111111111111111111
1000000000010001100010001000010000001111000011111111110000000001000110001000100001000000111100000000000001
1111111111111111111111111111111111111111111111111111111111111111111111111111111111111111111111111111111111